# # # # # # # # # # # # # # # # #
# . . . . . . . . . . # . # . . #
# # # # # . # # # . . . . # . # #
# . . . . . . . . . # . . . . . #
# . # # # . # . # . # . # . # . #
# . # . # . # . # . # . # . # . #
# . # . # . # . # . . # # . # . #
# . # . . . # . # # . # . # . . #
# . . . # # # . . # . . . . . # #
# . . . . . . . # # . # # . . . #
# # # # . # . . . # . # . . # . #
# . . . . # . # . . . # # . # . #
# . # # . # . # T # . . . . . . #
# # # # # # # # # # # # # # # # #
